Awhi	Abeoforma_whisleri
Acas	Acanthamoeba_castellanii
Apla	Acanthaster_planci
Adig	Acropora_digitifera
Apis	Acyrthosiphon_pisum
Avag	Adineta_vaga
Aaeg	Aedes_aegypti
Aipt	Aiptasia_spp
Alai	Albugo_laibachii
Amac	Allomyces_macrogynus
Atri	Amborella_trichopoda
Acer	Amoebophrya_ceratii
Aque	Amphimedon_queenslandica
Ancsig	Ancyromonas_sigmoides
Andgod	Andalucia_godoyi
Angdea	Angomonas_deanei
Amel	Apis_mellifera
Aker	Aplanochytrium_kerguelense
Acoe	Aquilegia_coerulea
Atha	Arabidopsis_thaliana
Alim	Aurantiochytrium_limacinum
Auraur	Aurelia_aurita_GOLD
Aano	Aureococcus_anophagefferens
Azfi	Azolla_filiculoides
Bden	Batrachochytrium_dendrobatidis
Bnat	Bigelowiella_natans
Bglb	Biomphalaria_glabrata
Blahom	Blastocystis_hominis
Bsal	Bodo_saltans
Bmor	Bombyx_mori
Bdis	Brachypodium_distachyon
Bbel	Branchiostoma_belcheri
Cele	Caenorhabditis_elegans
Cmil	Callorhinchus_milii
Ctel	Capitella_teleta
Cowc	Capsaspora_owczarzaki
Cang	Catenaria_anguillulae
Clen	Caulerpa_lentillifera
Cscu	Centruroides_sculpturatus
Cbra	Chara_braunii
Crei	Chlamydomonas_reinhardtii
Cvar	Chlorella_variabilis
Ccri	Chondrus_crispus
Cvel	Chromera_velia
Nk52	Chromosphaera_perkinsii
Ctob	Chrysochromulina_tobin
Cint	Ciona_intestinalis
Coka	Cladosiphon_okamuranus
Cocsub	Coccomyxa_subellipsoidea
Crev	Coemansia_reversa
Ccor	Conidiobolus_coronatus
Ccin	Coprinopsis_cinerea
Clim	Corallochytrium_limacisporum
Cgig	Crassostrea_gigas
Cfra	Creolimax_fragrantissima
Cneo	Cryptococcus_neoformans
Cparv	Cryptosporidium_parvum
Cpar	Cyanophora_paradoxa
Cmer	Cycnidioschyzion_merolae
Drer	Danio_rerio
Dpul	Daphnia_pulex
Ddis	Dictyostelium_discoideum
Diprot	Diphylleia_rotans
Dmel	Drosophila_melanogaster
Dunsal	Dunaliella_salina
Emul	Echinoccocus_multilocularis
Esil	Ectocarpus_siliculosus
Eten	Eimeria_tenella
Ehux	Emiliania_huxleyi
Ecun	Encephalitozoon_cuniculi
Ehis	Enthamoeba_histolytica
Fabtro	Fabomonas_tropica
Falb	Fonticula_alba
Fspp	Fungia_spp
Gfas	Galaxea_fascicularis
Glam	Giardia_lamblia
Gpro	Gonapodya_prolifera
Gasp	Goniastrea_aspera
Gavo	Goniomonas_avonlea
Gchorda	Gracilariopsis_chorda
Gthe	Guillardia_theta
Hrob	Helobdella_robusta
Hemkuk	Hemimastix_kukwesjijk
Hmia	Hofstenia_miamia
Hsap	Homo_sapiens
Hmag	Hydra_magnipapillata
Hmag	Hydra_siebert
Hduj	Hypsibius_dujardini
Ihof	Ichthyophonus_hoferi
Imul	Ichthyophthirius_multifiliis
Kipbia	Kipferlia_bialata
Kfla	Klebsormidium_flaccidum
Lmaj	Leishmania_major
Lsal	Lepeophtheirus_salmonis
Lepsey	Leptomonas_seymouri
Lcom	Leucosolenia_complicata
Lpol	Limulus_polyphemus
Lan	Lingula_anatina
Lgig	Lottia_gigantea
Malcal	Malawimonas_californiana
Maljak	Malawimonas_jakobiformis
Manpla	Mantamonas_plastica
Mpol	Marchantia_polymorpha
Mpus	Micromonas_pusilla
Mgut	Mimulus_guttatus
Mvib	Ministeria_vibrans_6frame
Mlei	Mnemiopsis_leidyi
Mbre	Monosiga_brevicollis
Mvir	Morbakka_virulenta
Mver	Mortierella_verticillata
Mcir	Mucor_circinelloides
Ngru	Naegleria_gruberi
Ngad	Nannochloropsis_gaditana
Npar	Nematocida_parisii
Nvec	Nematostella_vectensis
Ncra	Neurospora_crassa
Ngen	Notospermus_geniculatus
Nspp	Nuclearia_spp
Nutlon	Nutomonas_longa
Obim	Octopus_bimaculoides
Odio	Oikopleura_dioica
Ocar	Oscarella_carmela
Otau	Ostreococcus_tauri
Otri	Oxytricha_trifallax
Ptet	Paramecium_tetraurelia
Parsac	Paramicrosporidium_saccamoebae
Phaw	Parhyale_hawaiensis
Pmar	Perkinsus_marinus
Pmar	Petromyzon_marinus
Ptri	Phaeodactylum_tricornutum
Paus	Phoronis_australis
Pbla	Phycomyces_blakesleeanus
Ppat	Physcomitrella_patens
Pinf	Phytophthora_infestans
Pisp	Piromyces_spE2
Pgem	Pirum_gemmata
Pbra	Plasmodiophora_brassicae
Pfal	Plasmodium_falciparum
Pbac	Pleurobrachia_bachei
Ppal	Polysphondylium_pallidum
Prypar	Prymnesium_parvum
Pygbif	Pygsuia_biforma
Pyez	Pyropia_yezoensis
Rvar	Ramazzottius_varieornatus
Rfil	Reticulomyxa_filosa
Rirr	Rhizophagus_irregularis
Rory	Rhizopus_oryzae
Rigram	Rigifila_ramosa
Rall	Rozella_allomycis
Sjap	Saccharina_japonica
Scer	Saccharomyces_cerevisiae
Skow	Saccoglossus_kowalevskii
Sros	Salpingoeca_rosetta
Sacu	Salvinia_cucullata
Spar	Saprolegnia_parasitica
Sawmar	Sawyeria_marylandensis
Sman	Schistosoma_mansoni
Sagg	Schizochytrium_aggregatum
Spom	Schizosaccharomyces_pombe
Smoe	Selaginella_moellendorffii
Sbic	Sorghum_bicolor
Sarc	Sphaeroforma_arctica
Sdes	Sphaerothecum_destruens_6fr
Sphpha	Sphagnum_phallax
Spimul	Spironema_multiciliatum
Spisal	Spironucleus_salmonicida
Spun	Spizellomyces_punctatus
Smal	Stegodyphus_mimosarum
Smar	Strigamia_maritima
Strcul	Strigomonas_culicis
Spur	Strongylocentrotus_purpuratus
Styinc	Stygiella_incarcerata
Spis	Stylophora_pistillata
Scil	Sycon_ciliatum
Skaw	Symbiodinium_kawagutii
Smin	Symbiodinium_minutum
Tetwil	Tethya_wilhelma
Tthe	Tetrahymena_thermophila
Turt	Tetranychus_urticae
Tpse	Thalassiosira_pseudonana
Ttra	Thecamonas_trahens
Tkit	Thelohanellus_kitauei
Tgon	Toxoplasma_gondii
Tcas	Tribolium_castaneum
Tspi	Trichinella_spiralis
Tvag	Trichomonas_vaginalis
Tadh	Trichoplax_adhaerens
Trimar	Trimastix_marina
Tcru	Trypanosoma_cruzi
Tmel	Tuber_melanosporum
Umut	Ulva_mutabilis
Umar	Umbelopsis_ramanniana
Umay	Ustilago_maydis
Vbra	Vitrella_brassicaformis
Vcar	Volvox_cartieri
Xboc	Xenoturbella_bockii
Znev	Zootermopsis_nevadensis
